1 0 0 0 0 C 0 0 0 C 0 0 0 C 0 0 0 C b 0 0 C 0 0 0 C 0 0 0 C 1 1
D 0 0 0 0 0 0 0 0 0 0 0 0 0 0 0 0 0 0 0 0 0 0 0 0 0 0 0 0 0 1 1
D 0 0 0 0 0 0 s 0 0 0 0 0 0 0 0 0 0 0 0 0 0 0 0 0 0 0 0 0 0 1 1
D 0 0 0 0 E 0 0 0 0 E 0 0 0 0 0 0 0 0 0 0 0 0 0 0 0 0 0 0 0 1 1
1 1 0 A 0 0 1 1 1 1 0 0 2 2 1 1 1 1 0 0 0 0 k 1 2 2 2 2 0 0 k 1
1 0 0 0 0 0 0 0 1 1 0 0 0 0 1 1 1 0 0 0 0 0 1 1 0 0 0 0 0 0 k 1
1 0 0 0 2 2 0 0 1 1 0 0 0 0 1 1 1 0 1 1 s 0 1 1 0 0 0 0 R S 1 1
1 0 0 0 0 0 0 0 1 1 0 0 0 0 1 1 1 0 0 0 0 0 1 1 0 0 0 R 0 0 1 1
1 0 0 0 0 0 0 0 1 1 0 0 0 0 1 1 1 0 0 0 1 1 1 0 0 P R 0 0 0 1 1
1 0 0 0 0 0 0 0 1 1 0 0 0 0 1 1 1 0 0 0 0 0 0 0 0 R 0 0 0 0 1 1
1 0 0 0 0 0 0 0 1 1 0 0 0 0 1 1 1 0 0 0 0 0 0 0 R 0 0 0 0 0 1 1
1 7 7 7 7 7 7 7 1 1 7 7 7 7 1 1 1 7 7 7 7 7 Z R 0 0 0 7 7 7 1 1