1 0 0 0 0 0 0 0 0 0 0 0 0 0 0 0 0 0 0 0 0 0 0 0 0 0 0 0 0 0 0 1
0 0 0 0 0 0 0 0 0 0 0 0 0 0 0 0 0 0 0 0 0 0 0 0 0 0 0 0 0 0 0 1
0 0 0 P 0 0 0 0 0 0 0 0 0 0 0 0 0 0 0 0 0 0 0 0 0 0 0 0 0 0 0 D
0 0 0 0 0 0 0 0 0 0 0 0 0 0 0 0 0 0 0 0 0 0 0 0 0 0 0 0 0 0 0 D
1 1 1 1 1 1 1 1 0 0 0 0 0 0 0 0 0 0 0 0 0 0 0 0 0 0 2 2 2 2 2 1
1 0 0 0 0 0 0 0 0 0 0 0 0 0 0 0 1 1 1 1 2 2 0 0 0 0 0 0 0 0 0 1
1 0 0 0 0 0 0 0 2 2 S L 0 0 0 0 1 1 1 1 0 0 2 2 S L 0 0 0 0 0 1
1 0 0 0 0 0 0 0 0 0 0 0 L 0 0 0 1 1 1 1 0 0 0 0 0 0 L 0 0 0 0 1
1 0 0 0 0 0 0 0 0 0 0 0 0 L 0 0 1 1 1 1 0 0 0 0 0 0 0 L 0 0 0 1
1 0 0 0 8 0 0 0 0 0 0 0 0 0 L 0 1 1 1 1 0 0 0 0 9 0 0 0 L 0 0 1
1 1 S L S 1 1 1 1 1 1 1 1 1 1 1 1 1 1 1 1 1 S L S 1 1 1 1 1 1 1
0 0 0 0 L X 0 0 0 0 0 0 0 0 0 0 0 0 0 0 0 0 0 0 L W 0 0 0 0 0 0