1 0 b 0 0 0 0 8 X C 0 0 0 0 1 1
1 0 0 0 0 0 0 R 0 0 0 0 0 0 1 1
1 0 0 0 0 0 R 0 s 0 0 0 0 0 1 1
1 1 0 0 0 R 0 0 0 0 E 0 0 0 1 1
1 1 1 1 1 1 1 1 1 2 0 0 0 0 1 1
1 1 0 0 0 0 0 0 0 0 0 0 0 0 1 1
1 1 0 0 0 C 0 0 0 0 R S S C 1 1
1 0 0 0 0 0 0 0 0 R 0 0 0 0 1 1
1 0 P 0 0 0 0 0 R 0 0 0 0 0 1 1
1 0 0 0 0 0 0 R 0 0 0 0 0 0 1 1
1 1 1 1 1 1 1 1 1 1 1 1 1 1 1 1
0 0 0 0 0 0 0 0 0 0 0 0 0 0 0 0