3 1 0 0 0 0 0 0 0 0 0 0 0 0 E 0 3 0 0 0 0 0 0 0 0 0 0 0 0 0 0 0 0 0 0 0 0 0 0 0 0 0 0 0 0 0 1 1
3 1 0 0 0 0 0 0 0 0 0 0 0 0 E 0 3 0 0 0 0 0 0 0 0 0 0 0 0 0 0 0 0 0 0 0 0 0 0 0 0 0 0 0 0 0 1 1
3 1 0 0 0 0 0 0 0 0 0 0 0 0 E 0 3 0 0 0 0 0 0 0 0 0 0 0 0 0 0 0 0 0 0 0 0 0 0 0 0 0 0 0 0 0 1 1
3 1 0 0 4 0 0 0 0 0 0 0 0 0 E 0 3 0 0 0 0 0 0 0 0 0 0 0 0 0 0 0 0 0 0 0 0 0 0 0 0 0 0 0 0 0 1 1
3 1 0 0 4 0 0 0 0 0 0 0 0 C E 0 3 C 0 0 0 C 0 0 0 C 0 0 0 C 0 0 0 C 0 0 0 C 0 0 0 C 0 0 0 C 1 1
3 0 0 0 4 0 m 0 0 0 0 0 0 0 E 0 3 0 0 0 0 0 0 0 0 0 0 0 0 0 0 0 0 0 0 0 0 0 0 0 0 0 0 0 0 0 1 1
3 0 0 0 4 0 0 0 0 0 0 0 0 0 E 0 3 0 0 0 0 0 0 0 0 0 0 0 0 0 0 0 0 0 0 0 0 0 0 0 0 0 0 0 0 0 1 1
3 0 0 0 4 0 0 0 0 0 0 0 0 0 1 1 1 1 1 1 1 1 1 1 1 1 1 1 1 1 1 1 1 1 1 1 1 1 1 1 1 1 S S 0 0 1 1
1 1 1 1 1 1 1 1 1 1 1 1 1 1 E 1 3 1 1 1 1 1 1 1 1 1 1 1 1 1 1 1 0 0 0 0 0 0 0 0 0 0 0 P R S 1 1
1 1 1 1 1 1 1 1 1 1 1 1 1 1 E 3 1 1 1 1 1 1 1 1 1 1 1 1 1 1 1 1 0 0 0 0 0 0 0 0 0 0 0 R 0 0 1 1
1 1 1 1 1 1 1 1 1 1 1 1 1 1 E 1 1 1 1 1 1 1 1 1 1 1 1 1 1 1 1 1 0 0 0 0 0 0 0 0 0 0 R 0 0 0 1 1
0 0 0 0 0 0 0 0 0 0 0 0 0 0 0 0 0 0 0 0 0 0 0 0 0 0 0 0 0 0 0 0 0 0 0 0 0 0 0 0 Z R 0 0 0 0 0 0