1 0 0 0 0 0 0 0 R 0 0 0 0 0 1 1
1 0 0 0 0 0 0 R 0 0 0 0 0 0 1 1
1 0 0 0 0 0 R 0 0 0 0 0 0 0 1 1
1 1 0 0 0 R 0 0 0 0 0 0 0 0 1 1
1 1 1 1 1 1 1 1 1 S 0 0 0 0 1 1
1 1 0 0 0 0 0 0 0 0 0 0 0 0 1 1
1 1 0 0 0 0 0 0 0 0 R S 1 1 1 1
1 0 0 0 0 0 0 0 0 R 0 0 0 0 1 1
1 0 P 0 0 0 0 0 R 0 0 0 0 0 1 1
1 0 0 0 0 0 0 R 0 0 0 0 0 0 1 1
1 1 1 1 1 1 1 1 1 1 1 1 1 1 1 1
0 0 0 0 0 0 0 0 0 0 0 0 0 0 0 0